1111111111111111111
1P00000000C00000001
10011C00C0100D00C01
111000G00100C000001
1E0000001C000M001C1
1111111111111111111