1111111111111111111
1P00000000C00000001
10011C00C0001000C01
11100000010MCD00001
1E000D001C0010001C1
1111111111111111111