1111111111111111111
1P00000000C00000001
10011C00C0100000C01
11100000010MC020001
1E000D001C0000001C1
1111111111111111111