11111111111111
1100000C0001C1
10C10C00100001
10D00111110C01
1P0011E00C0001
11111111111111