1111111111111111111
1P00000000C00000001
10011C00C0100000C01
111000000100C000001
1E0000001C0000001C1
1111111111111111111