1111111111111
11111P11111C1
1000001000101
10111010D0C01
1C100000011D1
1000111100001
1010111100111
10100D1C00001
10C1011111001
11110000C10E1
1111111111111