11111111111
10C11P00C01
11100000001
1E00101C101
11111111111