1111111111111
10010C00C0C01
1000011111001
1P00110000001
1111111111111