11111111111
100C0P00C01
11101000001
1CE0101C101
11111111111