1111111111111
10010C000E001
1000011111001
1P00110000E01
1111111111111