111111\n
111111\n
111111\n
111111\nEOF *line
NULL hypothetically