111111
100CP1
111111
1000E1
111111
