1111111111111111111
1P00000000C00000001
10011000C0100000C01
11100C000100C000001
1E0000001C000001C11
1111111111111111111